29
28
1111111111111111111111111111
1222222222222112222222222221
1211112111112112111112111121
1411112111112112111112111141
1211112111112112111112111121
1222222222222222222222222221
1211112112111111112112111121
1211112112111111112112111121
1222222112222112222112222221
1111112111113113111112111111
0000012111113113111112100000
0000012113333333333112100000
1111112113111991113112111111
3333332333155555513332333333
1111112113111111113112111111
0000012113333333333112100000
0000012113111111113112100000
1111112113111111113112111111
1222222222222112222222222221
1211112111112112111112111121
1211112111112112111112111121
1422112222222222222222112241
1112112112111111112112112111
1112112112111111112112112111
1222222112222112222112222221
1211111111112112111111111121
1211111111112112111111111121
1222222222222222222222222221
1111111111111111111111111111
